Basic
Level = "レベル"
Level (Short) = "Lv"
HP = "ＨＰ"
HP (Short) = "HP"
MP = "ＭＰ"
MP (Short) = "MP"
TP = "ＴＰ"
TP (Short) = "TP"

Params
Maximum HP = "最大ＨＰ"
Maximum MP = "最大ＭＰ"
Attack Power = "攻撃力"
Defense = "防御力"
Magic Power = "魔法力"
Magic Defense = "魔法防御"
Agility = "敏捷性"
Luck = "技量"

ETypes
Weapon = "武器"
Shield = "盾"
Head = "頭"
Body = "身体"
Ornaments = "装飾品"

Commands
Fight = "戦う"
Escape = "逃げる"
Attack = "攻撃"
Defend = "防御"
Item = "アイテム"
Skill = "スキル"
Equipment = "装備"
Status = "ステータス"
Sorting = "並び替え"
Save = "セーブ"
End of Game = "ゲーム終了"
(Missing Number) = ""
Weapons = "武器"
Armor = "防具"
Valuables = "大事なもの"
Change Equipment = "装備変更"
Best Equipment = "最強装備"
Remove All = "全て外す"
New Game = "ベリーハード"
Continue = "コンティニュー"
Shutdown = "シャットダウン"
Go to Title = "タイトルへ"
Quit = "やめる"
